#########################
#########################
#########################
#################$#######
####...#........#...#.###
####.#.#.###.####.#.#.###
####.#.....#.#....#.#.###
####.#######.#.######.###
####.....#...#..#.....###
########.#.#.##...###.###
####.....#.#..#####.#.###
####.#####.##.#.....#.###
####.#...#.#..#.###.#.###
####...###.##.#...#.#.###
######.#....#####.#.#.###
####...#.##.#...#.#.#.###
####.###.#..#.#...#.#.###
####...#.#.##.#####.#.###
######.#.#.#..#...#...###
###@.#.#.###.##.#.#######
####...#........#.....###
#########################
#########################
#########################
#########################